-G--X---
--X-XX--
--------
XX---XXX
S---X---